11111111111111111111111111111111111111111111111111111111111111111111
1E0000000000000C00000C0000000000011E0000000000000C00000C000000000001
10000100001000000000000000000100011E0000000000000C00000C000000000001
10000100001000000000010000000100011E0000000000000C00000C000000000001
1P0000000C00C0000000000000000000C11E0000000000000C00000C000000000001
1000000000000000000C00C00C000000000E0000000000000C00000C000000000001
1000000000000000000C00C00C000000000E0000000000000C00000C000000000001
1000000000000000000C00C00C000000011E0000000000000C00000C000000000001
11111111111111110001111111111111111E0000000000000C00000C000000000001
11111111111111100000111111111111111E0000000000000C00000C000000000001
1E0000000000000C00000C0000000000011E0000000000000C00000C000000000001
1000010000000000000000000000000011E0000000000000C00000C000000000001
10000100100010000000100000000000011E0000000000000C00000C000000000001
100000000C00C0000000000000000000C11E0000000000000C00000C000000000001
1000000000000000000C00C00C000000011E0000000000000C00000C000000000001
1000000000000000000C00C00C000000011E0000000000000C00000C000000000001
1000000000000000000C00C00C000000011E0000000000000C00000C000000000001
11111111111111000000011111111111111E0000000000000C00000C000000000001
1E0000000000000C00000C0000000000011E0000000000000C00000C000000000001
10000100000000001000000000000100000E0000000000000C00000C000000000001
10000100100010000000010000000100000E0000000000000C00000C000000000001
100000000C00C0000000000000000000C11E0000000000000C00000C000000000001
1000000000000000000C00C00C000000000E0000000000000C00000C000000000001
1000000000000000000C00C00C000000000E0000000000000C00000C000000000001
1000000000000000000C00C00C000000011E0000000000000C00000C000000000001
1E0000000000000C00000C0000000000011E0000000000000C00000C000000000001
10000100001000001000010000000100011E0000000000000C00000C000000000001
10000100000000000000010000000100011E0000000000000C00000C000000000001
100000000C00C0000000000000000000C11E0000000000000C00000C000000000001
1000000000000000000C00C00C000000000E0000000000000C00000C000000000001
1000000000000000000C00C00C000000000E0000000000000C00000C000000000001
1000000000000000000C00C00C000000011E0000000000000C00000C000000000001
11111111111111110001111111111111111E0000000000000C00000C000000000001
11111111111111100000111111111111111E0000000000000C00000C000000000001
1E0000000000000C00000C0000000000011E0000000000000C00000C000000000001
11111111111111111111111111111111111111111111111111111111111111111111
