11111111111111111111111111111111111111111111111111111111111111111111
1E0000000000000C00000C0000000000011E0000000000000C00000C000000000001
10100101001000001010010000000101011E0000000000000C00000C000000000001
10100100101010100010010000000101011E0000000000000C00000C000000000001
1P0000000C00C0000000000000000000C11E0000000000000C00000C000000000001
1000000000000000000C00C00C000000000E0000000000000C00000C000000000001
1000000000000000000C00C00C000000000E0000000000000C00000C000000000001
1000000000000000000C00C00C000000011E0000000000000C00000C000000000001
11111111111111110001111111111111111E0000000000000C00000C000000000001
11111111111111100000111111111111111E0000000000000C00000C000000000001
1E0000000000000C00000C0000000000011E0000000000000C00000C000000000001
10100101001000001010010000000101011E0000000000000C00000C000000000001
10100100101010100010010000000101011E0000000000000C00000C000000000001
100000000C00C0000000000000000000C11E0000000000000C00000C000000000001
1000000000000000000C00C00C000000011E0000000000000C00000C000000000001
1000000000000000000C00C00C000000011E0000000000000C00000C000000000001
1000000000000000000C00C00C000000011E0000000000000C00000C000000000001
11111111111111000000011111111111111E0000000000000C00000C000000000001
1E0000000000000C00000C0000000000011E0000000000000C00000C000000000001
10100101001000001010010000000101000E0000000000000C00000C000000000001
10100100101010100010010000000101011E0000000000000C00000C000000000001
100000000C00C0000000000000000000C11E0000000000000C00000C000000000001
1000000000000000000C00C00C000000000E0000000000000C00000C000000000001
1000000000000000000C00C00C000000011E0000000000000C00000C000000000001
1000000000000000000C00C00C000000011E0000000000000C00000C000000000001
1E0000000000000C00000C0000000000011E0000000000000C00000C000000000001
10100101001000001010010000000101011E0000000000000C00000C000000000001
10100100101010100010010000000101011E0000000000000C00000C000000000001
100000000C00C0000000000000000000C11E0000000000000C00000C000000000001
1000000000000000000C00C00C000000000E0000000000000C00000C000000000001
1000000000000000000C00C00C000000000E0000000000000C00000C000000000001
1000000000000000000C00C00C000000011E0000000000000C00000C000000000001
11111111111111110001111111111111111E0000000000000C00000C000000000001
11111111111111100000111111111111111E0000000000000C00000C000000000001
1E0000000000000C00000C0000000000011E0000000000000C00000C000000000001
10100101001000001010010000000101011E0000000000000C00000C000000000001
10100100101010100010010000000101011E0000000000000C00000C000000000001
11111111111111111111111111111111111111111111111111111111111111111111
