111111111111111111111111111111
100000000000000C0000000C0000C1
101111111111100001111111111101
1C1000000000100001000000000101
10100E00C0000000000000C00001C1
1010C000000000P0000C00000C0101
1010000C000000000000C000E00101
1010000000001000010000000001C1
101111111111100001111111111101
100000000000000C0000000C000001
111111111111111111111111111111
