1111111111111111111111111111111111
1000000000000000000C0000000C0000C1
1011111111111000000001111111111101
1C10000000001000000001000000000101
10100E00C00000000000000000C00001C1
1010C00000000000P000000C00000C0101
1010000C0000000000000000C000E00101
10100000000010000000010000000001C1
1011111111111000000001111111111101
100000000000000C00000000000C000001
1111111111111111111111111111111111
