

111111111111
1001E00E0001
1C0001111001
10P1000C00C1
111111111111



